7
#######
###   #
# +#B #
# *   #
# * B #
# .#  #
#######