8
6
  ##### 
###   # 
# B # ##
# #  . #
#    # #
## #   #
 #P  ###
 #####