8
 #######
## .   #
# B#.# #
#  B . #
#  #B#.#
##P  B #
 ##   ##
  #####