7
0
####
#. #####
# B    #
# PB   #
##*    #
#.  ####
#####