7
0
  #####
###   #
#   $ #
### B #
#   # #
#.    #
####### 

