6
0
###
#.#####
#..   #
# BBBP#
#    ##
######