7
####
#. ##
# B #
# P #
##B #
#.  #
#####