8
##########
#        #
# BBB#B# #
# ..B. . #
# ###BBB #
# #..+.# #
#        #
##########