10
27
#######
#  +  #
# *B* #
#. # .#
#  #  #
#  #  #
#  #  #
# B#B #
#  #  #
#######