11
24
  #####
###   #
#   # #
# # B #
# B # #
# # B #
# B ###
### . #
 # . .#
 # P. #
 ######